5 5 0 0 4 4
1 2 7 1 1
1 2 4 1 1
1 2 3 1 2
1 2 0 2 4
1 2 0 4 5

10 10 1 0 8 9
0 1 0 0 0 0 0 0 0 0
0 1 1 0 1 1 1 0 1 0
0 1 1 0 1 1 1 0 1 0
0 1 1 1 1 0 1 1 1 0
0 0 0 1 0 1 1 0 0 0
0 1 1 1 0 1 1 1 1 0
0 1 0 1 0 1 0 1 1 0
0 1 0 0 0 1 0 0 1 0
0 1 1 1 1 1 1 1 1 0
0 0 0 0 0 0 0 0 1 0