5 5 0 0 4 4
1 2 7 1 1
1 2 4 1 1
1 2 3 1 2
1 2 0 2 4
1 2 0 4 5

